NO ./textures/xpm/1.xpm
SO ./textures/xpm/1.xpm
WE ./textures/xpm/1.xpm
EA ./textures/xpm/1.xpm

F 70,70,70
C 0,     255,204

111111111111111111
10100001
1000W001
10001001
10010001
10001011
10001011
11111111