NO ./textures/xpm/grafiti.xpm
SO ./textures/xpm/concrete.xpm
WE ./textures/xpm/stone.xpm
EA ./textures/xpm/wood.xpm

F 0,0,0
C 255, 255 , 255

1111111111111111111111111111111111
1000000111000000000110000000000001
1000000001011000001110000000000001
1001000000000000000000000000000001
111111111011000001110000000000001
100000000011000001110111110111111
111101111111110111000000000011111
11110111111111011101D100100010111
110000001101010111000000100011111
10000000000000001100000010D011111
100000000000000011010100100011111
11000001110101011111011110N011111
11110111 1110101 1011110100011111
11111111 1111111 1111111111111111
