NO ./textures/xpm/grafiti.xpm
SO ./textures/xpm/concrete.xpm
WE ./textures/xpm/stone.xpm
EA ./textures/xpm/wood.xpm

F 70,70,70
C 0, 255, 204

                  1111111111111111111111111
                  1000000000110000000000001
                  1011000001110000000000001                          1                                                         1                          1     1                        1
                  1001000000000000000000001
          111111111011000001110000000000001
          100000000011000001110111110111111
     1    11110111111111011100000010001         1
          11110111111111011101010010001
          11000000110101011100000010001
   1      100N0000000000001100000010001        1
          10000000000000001101010010001
          1100000111010101111101111000111
          11110111 1110101 101111010001
          11111111 1111111 111111111111       1
1
1
1
1
1
1
1
1
1
1
1
1
1
1
1
1
1
1
1
1
1
1
1
1
1
1
1
1
1
1
1     1 1 1 1 1  1 1 1 1111      111
