NO ./textures/xpm/grafiti.xpm
SO ./textures/xpm/concrete.xpm
WE ./textures/xpm/stone.xpm
EA ./textures/xpm/wood.xpm

F 70,70,70
C 0, 255, 204

11111111111111111111
10000000010100000001
10000000010100000001
10000000000000000001
10000000000000000001
10000000000000000001
10000000000000000001
10000000000000000001
10000000000000000001
1000000000S000000001
10000000000000000001
10000000000000000001
10000000000000000001
10000000000000000001
10000000000000000001
10000000000000000001
10000000000000000001
10000000000000000001
10000000010000000001
11111100000001111111
11111111111111111111
