F 255,0,100 
C 25,0,100 

1111111111111111111111111111111
1000000000000000000000001
111