NO ./textures/xpm/grafiti.xpm
SO ./textures/xpm/concrete.xpm
WE ./textures/xpm/stone.xpm
EA ./textures/xpm/wood.xpm

F 70,70,70
C 0, 255, 204

11111111111111111111111111111111111111111111111111111111111111111111111111111111111111111111111111111111111111111111111111111
10000000000000000000000000000000000000000000000000000000000000000000000000000000000000000000000000000000000000000000000000001
10000000000000000000000000000000000000000000000000000000000000000000000000000000000000000000000000000000000000000000000000001
10000000000000000000000000000000000000000000000000000000000000000000000000000000000000000000000000000000000000000000000000001
10000000000000000000000000000000000000000000000000000000000000000000000000000000000000000000000000000000000000000000000000001
100000000000000000000000000000000000000000000000000000000000000000S0000000000000000000000000000000000000000000000000000000001
10000000000000000000000000000000000000000000000000000000000000000000000000000000000000000000000000000000000000000000000000001
10000000000000000000000000000000000000000000000000000000000000000000000000000000000000000000000000000000000000000000000000001
10000000000000000000000000000000000000000000000000000000000000000000000000000000000000000000000000000000000000000000000000001
10000000000000000000000000000000000000000000000000000000000000000000000000000000000000000000000000000000000000000000000000001
10000000000000000000000000000000000000000000000000000000000000000000000000000000000000000000000000000000000000000000000000001
10000000000000000000000000000000000000000000000000000000000000000000000000000000000000000000000000000000000000000000000000001
10000000000000000000000000000000000000000000000000000000000000000000000000000000000000000000000000000000000000000000000000001
10000000000000000000000000000000000000000000000000000000000000000000000000000000000000000000000000000000000000000000000000001
10000000000000000000000000000000000000000000000000000000000000000000000000000000000000000000000000000000000000000000000000001
10000000000000000000000000000000000000000000000000000000000000000000000000000000000000000000000000000000000000000000000000001
10000000000000000000000000000000000000000000000000000000000000000000000000000000000000000000000000000000000000000000000000001
10000000000000000000000000000000000000000000000000000000000000000000000000000000000000000000000000000000000000000000000000001
10000000000000000000000000000000000000000000000000000000000000000000000000000000000000000000000000000000000000000000000000001
10000000000000000000000000000000000000000000000000000000000000000000000000000000000000000000000000000000000000000000000000001
10000000000000000000000000000000000000000000000000000000000000000000000000000000000000000000000000000000000000000000000000001
10000000000000000000000000000000000000000000000000000000000000000000000000000000000000000000000000000000000000000000000000001
10000000000000000000000000000000000000000000000000000000000000000000000000000000000000000000000000000000000000000000000000001
10000000000000000000000000000000000000000000000000000000000000000000000000000000000000000000000000000000000000000000000000001
10000000000000000000000000000000000000000000000000000000000000000000000000000000000000000000000000000000000000000000000000001
10000000000000000000000000000000000000000000000000000000000000000000000000000000000000000000000000000000000000000000000000001
10000000000000000000000000000000000000000000000011111111111111111000000000000000000000000000000000000000000000000000000000001
1000000000000000000000000000000000000000000000001               1000000000000000000000000000000000000000000000000000000000001
1000000000000000000000000000000000000000000000001               1000000000000000000000000000000000000000000000000000000000001
1000000000000000000000000000000000000000000000001               1000000000000000000000000000000000000000000000000000000000001
1000000000000000000000000000000000000000000000001               1000000000000000000000000000000000000000000000000000000000001
1000000000000000000000000000000000000000000000001               1000000000000000000000000000000000000000000000000000000000001
1000000000000000000000000000000000000000000000001               1000000000000000000000000000000000000000000000000000000000001
1000000000000000000000000000000000000000000000001               1000000000000000000000000000000000000000000000000000000000001
1000000000000000000000000000000000000000000000001               1000000000000000000000000000000000000000000000000000000000001
1000000000000000000000000000000000000000000000001               1000000000000000000000000000000000000000000000000000000000001
1000000000000000000000000000000000000000000000001               1000000000000000000000000000000000000000000000000000000000001
1000000000000000000000000000000000000000000000001               1000000000000000000000000000000000000000000000000000000000001
1000000000000000000000000000000000000000000000001               1000000000000000000000000000000000000000000000000000000000001
1000000000000000000000000000000000000000000000001               1000000000000000000000000000000000000000000000000000000000001
1000000000000000000000000000000000000000000000001               1000000000000000000000000000000000000000000000000000000000001
1000000000000000000000000000000000000000000000001               1000000000000000000000000000000000000000000000000000000000001
1000000000000000000000000000000000000000000000001               1000000000000000000000000000000000000000000000000000000000001
1000000000000000000000000000000000000000000000001               1000000000000000000000000000000000000000000000000000000000001
1000000000000000000000000000000000000000000000001               1000000000000000000000000000000000000000000000000000000000001
1000000000000000000000000000000000000000000000001               1000000000000000000000000000000000000000000000000000000000001
1000000000000000000000000000000000000000000000001               1000000000000000000000000000000000000000000000000000000000001
1000000000000000000000000000000000000000000000001               1000000000000000000000000000000000000000000000000000000000001
1000000000000000000000000000000000000000000000001               1000000000000000000000000000000000000000000000000000000000001
1000000000000000000000000000000000000000000000001               1000000000000000000000000000000000000000000000000000000000001
1000000000000000000000000000000000000000000000001               1000000000000000000000000000000000000000000000000000000000001
1000000000000000000000000000000000000000000000001               1000000000000000000000000000000000000000000000000000000000001
1000000000000000000000000000000000000000000000001               1000000000000000000000000000000000000000000000000000000000001
1000000000000000000000000000000000000000000000001               1000000000000000000000000000000000000000000000000000000000001
1000000000000000000000000000000000000000000000001               1000000000000000000000000000000000000000000000000000000000001
1000000000000000000000000000000000000000000000001               1000000000000000000000000000000000000000000000000000000000001
1000000000000000000000000000000000000000000000001               1000000000000000000000000000000000000000000000000000000000001
1000000000000000000000000000000000000000000000001               1000000000000000000000000000000000000000000000000000000000001
1000000000000000000000000000000000000000000000001               1000000000000000000000000000000000000000000000000000000000001
1000000000000000000000000000000000000000000000001               1000000000000000000000000000000000000000000000000000000000001
1000000000000000000000000000000000000000000000001               1000000000000000000000000000000000000000000000000000000000001
1000000000000000000000000000000000000000000000001               1000000000000000000000000000000000000000000000000000000000001
1000000000000000000000000000000000000000000000001               1000000000000000000000000000000000000000000000000000000000001
1000000000000000000000000000000000000000000000001               1000000000000000000000000000000000000000000000000000000000001
1000000000000000000000000000000000000000000000001               1000000000000000000000000000000000000000000000000000000000001
1000000000000000000000000000000000000000000000001               1000000000000000000000000000000000000000000000000000000000001
1000000000000000000000000000000000000000000000001               1000000000000000000000000000000000000000000000000000000000001
1000000000000000000000000000000000000000000000001               1000000000000000000000000000000000000000000000000000000000001
1000000000000000000000000000000000000000000000001               1000000000000000000000000000000000000000000000000000000000001
1000000000000000000000000000000000000000000000001               1000000000000000000000000000000000000000000000000000000000001
1000000000000000000000000000000000000000000000001               1000000000000000000000000000000000000000000000000000000000001
1000000000000000000000000000000000000000000000001               1000000000000000000000000000000000000000000000000000000000001
1000000000000000000000000000000000000000000000001               1000000000000000000000000000000000000000000000000000000000001
1000000000000000000000000000000000000000000000001               1000000000000000000000000000000000000000000000000000000000001
1000000000000000000000000000000000000000000000001               1000000000000000000000000000000000000000000000000000000000001
1000000000000000000000000000000000000000000000001               1000000000000000000000000000000000000000000000000000000000001
1000000000000000000000000000000000000000000000001               1000000000000000000000000000000000000000000000000000000000001
1000000000000000000000000000000000000000000000001               1000000000000000000000000000000000000000000000000000000000001
1000000000000000000000000000000000000000000000001               1000000000000000000000000000000000000000000000000000000000001
1000000000000000000000000000000000000000000000001               1000000000000000000000000000000000000000000000000000000000001
1000000000000000000000000000000000000000000000001               1000000000000000000000000000000000000000000000000000000000001
1000000000000000000000000000000000000000000000001               1000000000000000000000000000000000000000000000000000000000001
1000000000000000000000000000000000000000000000001               1000000000000000000000000000000000000000000000000000000000001
1000000000000000000000000000000000000000000000001               1000000000000000000000000000000000000000000000000000000000001
1000000000000000000000000000000000000000000000001               1000000000000000000000000000000000000000000000000000000000001
1000000000000000000000000000000000000000000000001               1000000000000000000000000000000000000000000000000000000000001
1000000000000000000000000000000000000000000000001               1000000000000000000000000000000000000000000000000000000000001
1000000000000000000000000000000000000000000000001               1000000000000000000000000000000000000000000000000000000000001
1000000000000000000000000000000000000000000000001               1000000000000000000000000000000000000000000000000000000000001
1000000000000000000000000000000000000000000000001               1000000000000000000000000000000000000000000000000000000000001
1000000000000000000000000000000000000000000000001               1000000000000000000000000000000000000000000000000000000000001
1000000000000000000000000000000000000000000000001               1000000000000000000000000000000000000000000000000000000000001
1000000000000000000000000000000000000000000000001               1000000000000000000000000000000000000000000000000000000000001
1000000000000000000000000000000000000000000000001               1000000000000000000000000000000000000000000000000000000000001
1000000000000000000000000000000000000000000000001               1000000000000000000000000000000000000000000000000000000000001
1000000000000000000000000000000000000000000000001               1000000000000000000000000000000000000000000000000000000000001
10000000000000000000000000000000000000000000000011111111111111111000000000000000000000000000000000000000000000000000000000001
10000000000000000000000000000000000000000000000000000000000000001000000000000000000000000000000000000000000000000000000000001
10000000000000000000000000000000000000000000000000000000000000000000000000000000000000000000000000000000000000000000000000001
10000000000000000000000000000000000000000000000000000000000000000000000000000000000000000000000000000000000000000000000000001
10000000000000000000000000000000000000000000000000000000000000000000000000000000000000000000000000000000000000000000000000001
10000000000000000000000000000000000000000000000000000000000000000000000000000000000000000000000000000000000000000000000000001
10000000000000000000000000000000000000000000000000000000000000000000000000000000000000000000000000000000000000000000000000001
10000000000000000000000000000000000000000000000000000000000000000000000000000000000000000000000000000000000000000000000000001
10000000000000000000000000000000000000000000000000000000000000000000000000000000000000000000000000000000000000000000000000001
10000000000000000000000000000000000000000000000000000000000000000000000000000000000000000000000000000000000000000000000000001
10000000000000000000000000000000000000000000000000000000000000000000000000000000000000000000000000000000000000000000000000001
10000000000000000000000000000000000000000000000000000000000000000000000000000000000000000000000000000000000000000000000000001
10000000000000000000000000000000000000000000000000000000000000000000000000000000000000000000000000000000000000000000000000001
10000000000000000000000000000000000000000000000000000000000000000000000000000000000000000000000000000000000000000000000000001
10000000000000000000000000000000000000000000000000000000000000000000000000000000000000000000000000000000000000000000000000001
10000000000000000000000000000000000000000000000000000000000000000000000000000000000000000000000000000000000000000000000000001
10000000000000000000000000000000000000000000000000000000000000000000000000000000000000000000000000000000000000000000000000001
10000000000000000000000000000000000000000000000000000000000000000000000000000000000000000000000000000000000000000000000000001
10000000000000000000000000000000000000000000000000000000000000000000000000000000000000000000000000000000000000000000000000001
10000000000000000000000000000000000000000000000000000000000000000000000000000000000000000000000000000000000000000000000000001
10000000000000000000000000000000000000000000000000000000000000000000000000000000000000000000000000000000000000000000000000001
11111111111111111111111111111111111111111111111111111111111111111111111111111111111111111111111111111111111111111111111111111
