   EA     /home/nate/Workspace/42projects/cube3d_42/textures/xpm/1.xpm
   NO     /home/nate/Workspace/42projects/cube3d_42/textures/xpm/1.xpm
WE     /home/nate/Workspace/42projects/cube3d_42/textures/xpm/1.xpm
SO    /home/nate/Workspace/42projects/cube3d_42/textures/xpm/1.xpm
           F 250,0,0
C                 125,1,1
	
	111111111111111111111111
100000000000001
100000000000000001
111111111111111111