   EA     ./textures/xpm/1.xpm     
   WE     ./textures/xpm/1.xpm     
            SO    ./textures/xpm/1.xpm
     NO  ./textures/xpm/1.xpm   



F 255,0,100 
C 25,0,100 
111111111111111111111111111111111111
