NO ./textures/xpm/grafiti.xpm
SO ./textures/xpm/concrete.xpm
WE ./textures/xpm/stone.xpm
EA ./textures/xpm/wood.xpm

F 200,200,200
C 200,            200,200

                    111111111111           
          1111111111100000000001   
          100000000W001111111111 
          1111111111111          