



EA     ./textures/xpm/1.xpm     
WE     ./textures/xpm/1.xpm     
     SO    ./textures/xpm/1.xpm
   NO  ./textures/xpm/1.xpm   
C 25,0,100 
F       255,0,0
11111111
  000
111N01
11111111