



EA     ./textures/xpm/1.xpm     
WE     ./textures/xpm/1.xpm     
     SO    ./textures/xpm/1.xpm
   NO  ./textures/xpm/1.xpm   
C 25,0,100
F       255,0,120
1111111111111111111111111111
1000000000000000011000000011
1000000000000000011000000011
1000000000000000011000000011
1000000000000000011000000011
1000000000000000011000000011
1111111111111111111111