



EA     ./textures/xpm/1.xpm     
WE     ./textures/xpm/1.xpm     
     SO    ./textures/xpm/1.xpm
   NO  ./textures/xpm/1.xpm   
C 25,0,25
F       255,0,255
1111111111111111111111111111
1000000000000000011000000011
1000000000000000011000000011
100000010000N000011000000011
1000000100000000011000000011
1000000100000000011000000011
1000000100000000011000000011
1000000100000000011000000011
1111111111111111111111111111
1000000100000000011000000011
1000000100000000011000000011
1000000100000000011000000011
1000000100000000011000000011
1000000000000000011000000011
1111111111111111111111