NO ./textures/xpm/1.xpm
SO ./textures/xpm/1.xpm
WE ./textures/xpm/1.xpm
EA ./textures/xpm/1.xpm





F 70,70,70
C 0, 255, 204






                  1111111111111111111111111    
                  1000000000110000000000001     
                  1011000001110000000000001     
                  1001000000000000000000001          
          111111111011000001110000000000001           
          100000000011000001110111110111111           
          11110111111111011100000010001         
          1111011111111101110101001000011111111111111111111101
          11000000110101011100000010001
          10000000000000001100000110001 
          10000000S00000001101010010001
          1100000111010101111101111010111
          11110111 1110101 101111010001
          11111111 1111111 111111111111
